-----------
-000000010F
-0000------
-0000------ 
-S000------
-----------
        