--------------
-C00000E0000C-
-00E0-0-----0-
-C000-E-----0-
-C--E-------0-
-C00000E0---C-
-00000000---0-
-00E00000---0-
-S0000000---1-
------------F-
        