--------------
-C00000E0000C-
-00E0-0-----0-
-C000-E-----0-
-SC0E-------1-
------------F-
        